R 680 400

NO ./textures/greystone.xpm
SO ./textures/colorstone.xpm
WE ./textures/bluestone.xpm
EA ./textures/mossy.xpm
S ./textures/barrel.xpm

F 105,105,105
C 0,173,234

                               111
        11111111111111111111111101
        10000000001100000000000011
        1011000001110000002000001
        100100000000000000000000
111111110011000001110000000000001
100000000011000001110111110111111
11110111111111011100000010001
11110111111111011101010010001
11000000110101011100000010001
10002000000000001100000000021
10000000000000001101010010021
10000001110101011111011110N0011
10110111 1110101 101111010001
10111111 1111111 111111111111
101
101
101
101
111
