R 600 400

NO ./textures/greystone.xpm
SO ./textures/colorstone.xpm
WE ./textures/bluestone.xpm
EA ./textures/mossy.xpm
S ./textures/barrel.xpm

F 105,105,105
C 0,173,234

                1
               101
              10001
             1000001
            100000001
           10000000001
          1002000000001
         100000000000001
        10000000000000001
       1000000000000000001
      100000000022000000001
     10000000000000000000001
    1000000000000000000200001
   100000000000000000000000001
  10000000000000000000000000001
 100000000000000N000000000000001
111111111111111111111111111111111
